-------------------------------                       
| D                           |                       
| --- --- --- --- --- --- --- |                       
| |A| | | | | | | | | | | | | |                       
| --- --- --- --- --- --- --- |                       
|                             |                       
| --- --- --- --- --- --- --- |                       
| | | | | | | | | | | | | | | |                       
| --- --- --- --- --- --- --- |                       
|                             |                       
| --- --- --- --- --- --- --- |                       
| | | | | |B| | | | | | | |E| |                       
| --- --- --- --- --- --- --- |                       
|                             |                       
| --- --- --- --- --- --- --- |                       
| | | | | | | | | | | | | | | |                       
| --- --- --- --- --- --- --- |    -------------------
|                             |    |                 |
| --- --- --- --- --- --- --- |----| --- --- --- --- |
| | | | | |D| | | | | | | | |        | | |X| | | | | |
| --- --- --- --- --- --- --- |----| --- --- --- --- |
|                             |    |                 |
-------------------------------    |-----------------|